{
	"backgroundcolor": "#656667",
	"height": 10,
	"layers": [
		{
			"data":  [
				1, 1, 1, 1, 1, 1, 1, 1, 1,      
				1, 0, 0, 0, 0, 0, 0, 0, 1, 
				1, 0, 0, 0, 0, 0, 0, 0, 1, 
				1, 0, 0, 0, 0, 0, 0, 0, 1, 
				1, 0, 0, 0, 0, 0, 0, 0, 1, 
				1, 0, 0, 0, 0, 0, 0, 0, 1, 
				1, 0, 0, 0, 0, 0, 0, 0, 1, 
				1, 0, 0, 0, 0, 0, 0, 0, 1, 
				1, 0, 0, 0, 0, 0, 0, 0, 1, 
				1, 1, 1, 1, 1, 1, 1, 1, 1 
			],
			"name": "background"
		}

	],
	"nextobjectid": 1,
	"tileheight": 16,
	"tilewidth": 16,
	"version": 1,
	"tiledversion": "1.0.3",
	"width": 9
}
