{
	"height": 10,
	"layers": [
		{
			"data":  [
				1, 1, 1, 1, 1, 1, 1, 1, 1, 1, 1, 
				1, 0, 0, 0, 0, 0, 0, 0, 0, 0, 1, 
				1, 0, 0, 0, 0, 0, 0, 0, 0, 0, 1, 
				1, 0, 0, 0, 0, 0, 0, 0, 0, 0, 1, 
				1, 0, 0, 0, 0, 0, 0, 0, 0, 0, 0, 
				1, 0, 0, 0, 0, 0, 0, 0, 0, 0, 0, 
				1, 0, 0, 0, 0, 0, 0, 0, 0, 0, 1, 
				1, 0, 0, 0, 0, 0, 0, 0, 0, 0, 1, 
				1, 0, 0, 0, 0, 0, 0, 0, 0, 0, 1, 
				1, 1, 1, 1, 1, 1, 1, 1, 1, 1, 1 
			],
			"width": 11,
			"height": 10
		},
		
		{
			"data":  [
				1, 1, 1, 1, 1, 1, 1, 1, 1, 1, 1, 
				1, 0, 0, 0, 0, 0, 0, 0, 0, 0, 1, 
				1, 0, 0, 0, 0, 0, 0, 0, 0, 0, 1, 
				1, 0, 0, 0, 0, 0, 0, 0, 0, 0, 1, 
				0, 0, 0, 0, 0, 0, 0, 0, 0, 0, 1, 
				0, 0, 0, 0, 0, 0, 0, 0, 0, 0, 1, 
				1, 0, 0, 0, 0, 0, 0, 0, 0, 0, 1, 
				1, 0, 0, 0, 0, 0, 0, 0, 0, 0, 1, 
				1, 0, 0, 0, 0, 0, 0, 0, 0, 0, 1, 
				1, 1, 1, 1, 1, 1, 1, 1, 1, 1, 1 
			],
			"width": 11,
			"height": 10
		}


	],
	"tileheight": 16,
	"tilewidth": 16,
	"tiledversion": "1.0.3",
	"width": 11,
	"tilesets": [
    {
      "tiles": [
        {
          "image": "tiles/floor.svg",
          "properties": [
            {
              "name": "collision", 
              "type": "int", 
              "value": 0
            }
          ]
        },
        {
          "image": "tiles/block.svg",
          "properties": [
            {
              "name": "collision", 
              "type": "int", 
              "value": 1
            }
          ]
        }
      ]
    }
	]
}
